1111
10001
1P10111
100000C1
1111001
10E1
111